-1	expression of disagreement or disapproval
+1	expression of agreement or approval
10-4	I understand your message
1337	elite, highly skilled
4oj	Fourth of July
5-0	police officers or warning that police is approaching
8-ball	1/8 of an ounce (approximately 3.5 grams) of abused drugs
a-cup	size of a woman's breast
a1	of excellent grade or condition
adv	advance
af	as fuck; expression of annoyance, contempt or impatience
afaik	as far as i know
afk	away from keyboard
afro	African or African American, especially of a style of music or clothing
afu	all fucked up; total failure or disaster
aggro	aggressive, provoking or violent behaviour
aka	also known as
alot	a lot
alt+f4	to exit a computer program, video game or chat room
apb	All Points Bulletin which is a broadcast to all police officers, often with information about a suspect who is to be detained.
asap	as soon as possible
aspie	person who has Asperger's Syndrome
assgut	slur for an overweight person
asshat	slur for a stupid or contemptible person
atm	at the moment
aussie	Australian
awol	Absent Without Official Leave
aww	expression of endearment or affection
b.o.	body odour
b&d	sexual practice of Bondage and Domination
badass	a tough, uncompromising, or intimidating person
bagina	vagina
baka	slur for a stupid or contemptible person
baller	affluent lifestyle
ballin	affluent lifestyle
bamf	a tough, uncompromising, or intimidating person
bandz	whole stack of dollar notes
banger	awesome or attractive person
bangin	exclamation of joy and excitement
barf	vomit
bb	baby
bbq	barbecue
bbs	be back soon
bbts	big black titties
bbw	big beautiful woman; overweight and attractive
bdsm	sexual practice of Bondage, Domination, Sadism and Masochism
beamer	nice car
beaner	illegal immigrant
bender	homosexual male
benzo	drugs used for treatment of anxiety
beotch	bitch; slur for an annoying or unpleasant female
beso	to kiss
besos	kisses
bestie	best friend
bf	boyfriend or best friend
bfd	big fucking deal
bff	best friends forever
bffl	best friends for life
bfl	scammed
bfo	best friend at work
biatch	bitch; slur for an annoying or unpleasant female
bilf	babysitter I will like to fuck
bilk	bitch I will like to kill
bint	bitch; slur for an annoying or unpleasant female
biotch	bitch; slur for an annoying or unpleasant female
bj	blow job; sexual act
bleh	expression of indifference or boredom
bling	expensive jewellery
bmao	blow my ass off
bobfoc	Body Off Baywatch, Face Off Crimewatch. A person who possesses a killer body but has a face that only a mother could love.
boi	boyish
boink	sexual intercourse
bolo	police term for Be On the Lookout
boned	to be caught in a very bad situation
boner	to be sexually aroused
boning	sexual intercourse
bonk	sexual intercourse
boob	a woman's breast
boobs	a woman's breast
booger	a piece of dried nasal mucus
boong	Australian
booya	exclamation of excitement
booyah	exclamation of excitement
borgle	stupid behaviour
borked	to cause equipment to stop working
boytoy	attractive male friend
brb	be right back
bro	male friend
brodeo	A get-together or a party where the attendance is prodominantly male.
brofie	a photograph that one has taken of oneself together with male friends
broham	male friend
brojob	homosexual male
brolic	muscular well-built male
broly	male friend
bruh	male friend
bruv	male friend
bsod	Blue Screen Of Death, a serious technical glitch
btfo	a sports term where the underdog team wins by a large margin
btjm	but that is just me
btw	by the way
bub	friend
bubs	friends
bugger	slur for an annoying or unpleasant person
bukake	sexual act that is derogatory for women
bummer	a disappointing or unpleasant situation or experience
burner	A throwaway prepaid cellphone, typically used by dealers. Used until the minutes are up, then thrown away so they cannot be tapped.
bwc	man's penis
byob	bring your own beer
c-cup	size of a woman's breast
caking	flirting
catty	subtly or indirectly insulting
cexy	sexy
chigga	Asians who are influenced by urban hip-hop culture
chink	racist term for Chinese people
chinks	racist term for Chinese people
chinky	racist term for Chinese people
chirps	chat up, woo, or court another person
chulo	good looking or sexually attractive
chump	slur for a stupid or contemptible person
ciao	greeting hello or goodbye
cim	Cum in Mouth
cocos	Cocaine
coed	integrated education of men and women at the same school facilities
colby	gangster
commie	derogatory term for a communist
convo	conversation
cooch	profanity for a woman's vagina
coolie	indentured labourers
coom	orgasm
cooter	profanity for a woman's vagina
copped	receive or attain something beneficial
cougar	an older woman who looks to get into a relationship with younger men
couger	an older woman who looks to get into a relationship with younger men
cretin	slur for a stupid or contemptible person
crikey	An Australian exclamation of surprise or bewilderment
crusty	rude or harsh person
csb	expression of disbelief
csi	search for and publish private or identifying information about (a particular individual) on the internet, typically with malicious intent
ctfd	Calm the fuck down
ctfu	laughing; crack the fuck up
cthu	laughing; crack the hell up
cuck	to make a cuckold of one's spouse
cuddy	friend
cuffed	in a heterosexual relationship with someone
cunny	profanity for a woman's vagina
cunt	profanity for a woman's vagina
cunty	bitch; slur for an annoying or unpleasant female
cuz	because
cya	bid goodbye
d-boy	drug dealer
d-cup	size of a woman's breast
d.o.a	dead on arrival
d'oh	expression of annoyance with a foolish or stupid action, especially one's own
dae	Does Anybody Else
dafuq	expression of confusion, what the fuck
daggy	out of fashion or untidy
dago	racist slur for Italians
damnit	damn; exclamation of anger or frustration or to add emphasis
dang	damn; exclamation of anger or frustration or to add emphasis
dap	The knocking of fists together as a greeting, or form of respect.
daps	The knocking of fists together as a greeting, or form of respect.
darkie	racist slur for black people
darky	racist slur for black people
dawg	friend of an African-American ethnic background
dayum	damn; exclamation of anger or frustration or to add emphasis
ddf	drug and disease free
deets	details
dego	racist slur for Italians
derpy	awkward or embarrassing behaviour
dfk	deep french kissing
dfl	in last position or rank
dftba	do not forget to be awesome
dfw	psyched to chill and hang out with friends
dgaf	don't give a fuck
dibs	to claim something
diddle	female masturbation
dilf	dad I will like to fuck
dinger	marksmanship with small arms
dink	Dual Income No Kids
diss	speak disrespectfully to or criticize
diu	fuck; expression of annoyance, contempt or impatience
diy	Do It Yourself
dnb	a 'Do Nothing Bitch'. A girl who wants to be all pretty and fancy, just to have someone take care of her.
doa	dead on arrival
doggy	sexual intercourse
dolt	slur for a stupid or contemptible person
doodoo	faeces
dookie	faeces
doosh	annoying or unpleasant person
doozy	an extraordinary one of its kind
dork	an odd, socially awkward, unstylish person
dosh	monetary amount
douche	annoying or unpleasant person
doussy	annoying or unpleasant person
dox	search for and publish private or identifying information about (a particular individual) on the internet, typically with malicious intent
dps	gaming term for damage per second
dtmfa	to get out of a toxic relationship
dtr	Define The Relationship
duces	bid goodbye
dud	a thing that fails to work properly or is otherwise unsatisfactory
dude	friend
duece	shit; an exclamation of disgust, anger, or annoyance
dueces	shit; an exclamation of disgust, anger, or annoyance
duh	comment on a foolish or stupid action, especially someone else's
dui	Driving Under the Influence (of alchohol)
dunch	not quite dinner but definitely past lunch
dunno	do not know
dunny	friend
dweeb	a boring, studious, or socially inept person
dweet	tweeting while intoxicated
dyme	very attractive female
e-bile	an email sent for the purpose of spewing anger, vitriol and complaint.
e-cup	size of a woman's breast
e-peen	ego or pride in the virtual world
e-void	Avoiding all digital communciations from someone
ebaum	to steal something and claim it as your own
ecchi	a subgenre of Japanese manga, anime, computer games, etc., characterized by light, playful sexual themes and imagery.
efg	Epic Fail Guy
emo	emotional
esrun	To send out automated spam
ew	exclamation of disgust
eww	exclamation of disgust
f.a.m.	family above money
f.t.w.	for the win
f'it	fuck it; expression of annoyance, contempt or impatience
f**k	fuck; expression of annoyance, contempt or impatience
f/u	follow up
fab	fabulous
fag	faggot; slur for an annoying or unpleasant person
fagget	faggot; slur for an annoying or unpleasant person
faggit	faggot; slur for an annoying or unpleasant person
faggle	a group of homosexual males
fagit	faggot; slur for an annoying or unpleasant person
fags	faggot; slur for an annoying or unpleasant person
fai	forget about it
fam	family
fap	masturbation
fape	masturbation
fappy	masturbation
faps	masturbation
fark	fuck; expression of annoyance, contempt or impatience
fatass	slur for an overweight person
fb	facebook
fbgm	fuck bitches get money; profanity for saying one's male friends are more important than female friends
fbsm	Full Body Sensual Massage
fcuk	fuck; expression of annoyance, contempt or impatience
feces	faeces
feck	fuck; expression of annoyance, contempt or impatience
feen	craving
feenin	craving
felch	sexual act
fellas	friends
feltch	sexual act
femdom	female domination, a sexual act
ffl	laughing; falling from laughing
ffox	firefox browser
ffs	for fuck's sake; expression of annoyance, contempt or impatience
fgt	faggot; slur for an annoying or unpleasant person
fify	fixed it for you
fiiq	fuck it I quit; expression of annoyance, contempt or impatience
fittie	sexually attractive
five-o	police officers
flakey	unreliable, absent-minded or irresponsible
flamer	flamboyant homosexual
fleek	extremely good, attractive, or stylish
flendy	trendy
flexin	showing off
floozy	slut; slur for a sexually promiscuous female
flope	uncool or unpopular person
fluck	flying fuck; expression of annoyance, contempt or impatience
flurge	slur for a sexually unattractive female
fmi	for my information
fml	fuck my life; expression of annoyance, contempt or impatience
fng	new joiner who is inexperienced or unskilled
foad	fuck off and die; expression of annoyance, contempt or impatience
fof	frown on face
fogo	fear of going out
foh	fuck off from here; expression of annoyance, contempt or impatience
fomo	fear of missing out
foodie	a person who looks for and enjoys good food
footy	football or soccer sports
fosu	fear of sobering up
frack	fuck; expression of annoyance, contempt or impatience
frag	kill an enemy in a video game
frak	fuck; expression of annoyance, contempt or impatience
frape	to prank someone's social media profile
fraped	to prank someone's social media profile
frig	female masturbation
ftfy	fixed that for you
ftl	for the loss
ftmfw	for the win
fts	fuck that shit; expression of annoyance, contempt or impatience
ftw	for the win
fu	fuck you; expression of annoyance, contempt or impatience
fuark	fuck; expression of annoyance, contempt or impatience
fubar	fucked up beyond all recognition; expression of annoyance, contempt or impatience
fud	scare tactics that employ Fear, Uncertainty and Doubt
fufu	fake
fug	fucking ugly
fugazi	fake
fugazy	fake
fugly	fucking ugly
fuk	fuck; expression of annoyance, contempt or impatience
fukkem	fuck them; expression of annoyance, contempt or impatience
fundie	fundamentalist or strict advocate
fungry	fucking hungry; very hungry
fuq	fuck; expression of annoyance, contempt or impatience
futa	fucked up the ass; expression of annoyance, contempt or impatience
fwiw	for what it's worth
fyi	for your information
g-spot	a sensitive area believed to exist in the anterior wall of the vagina and to be highly erogenous
g2g	got to go
gah	exclamation of anger or frustration
gaijin	foreigner
gams	attractive pair of female legs
ganga	slut; slur for a sexually promiscuous female
gank	to steal something or kill someone 
ganked	to steal something or kill someone 
gawd	exclamation of surprise or shock
gbf	gay best friend
gdb	bitch; slur for an annoying or unpleasant female
gdi	God Damn Independent, a college student who is not in a fraternity or sorority.
geezer	slur for older male
getcha	I understand
gf	girlfriend
gfe	Girl Friend Experience.
gfy	good for you
gg	good game
ghey	gay
giggin	dancing well
gilf	Grandmother I would Like to Fuck
gimp	slur for a stupid or contemptible person
gink	racist slur for a person of Indian descent
gitgo	from the very beginning
gj	good job
gl	good luck
glhf	good luck have fun
gmas	give me a second
gmy	good man yourself, to appreciate someone's action
gnar	difficult, dangerous, or challenging
gnarly	difficult, dangerous, or challenging
goga	girl-on-girl action
gooday	greeting hello
gook	racist slur for Korean people
goosed	to pinch someone's buttocks
gorpy	sloppy or messy
gosu	a person who is highly skilled especially in video games
gotcha	I understand
gpoy	gratuitous picture of yourself
greebo	an unkempt or dirty-looking young man
greezy	pleasing or good form or a happy occurrence
gress	racist slur for black female
gringo	foreigner
groovy	fashionable and exciting
gtfo	get the fuck out; expression of annoyance, contempt or impatience
gtg	got to go
guero	fair skinned or light haired person
guey	friend
gump	slur for a stupid or contemptible person
gurl	girl
gz	congratulations
h-o-e	whore; slur for a sexually promiscuous female
h.m.u	hit me up
h4x0r	computer hacker
habeeb	expression of endearment or affection
habibi	expression of endearment or affection
habs	expression of endearment or affection
hai	greeting hello
hangry	very hungry
haole	racist slur for white people
hapa	of mixed racial heritage with Pacific Islander ancestry
hardon	sexually aroused; hard-on
hawt	sexually attractive; hot
hazing	bullying new joiners through some initiation rite
hbd	happy birthday
hbic	bitch; slur for an annoying or unpleasant female
heffa	slur for an overweight person
heffer	slur for an overweight person
hiney	buttocks
hinky	unreliable or faulty
hj	hand job; sexual act
hobo	a homeless person; a tramp or vagrant
hoebag	whore; slur for a sexually promiscuous female
hoes	whore; slur for a sexually promiscuous female
hola	greeting hello
holla	greeting hello
homey	friend
homie	friend
homies	friends
homo	slur for homosexuals
honkey	slur for people from Hong Kong
honkie	slur for people from Hong Kong
honky	slur for people from Hong Kong
hooah	Heard Understood Acknowledged
hooch	alchohol
hoodie	sweatshirt with a hood
hooker	female prostitute
hoorah	Heard Understood Acknowledged
hoprah	fan of Oprah Winfrey
hore	whore; slur for a sexually promiscuous female
horney	sexually aroused
horny	sexually aroused
hoser	slur for a stupid or contemptible person
hott	sexually attractive
hottie	sexually attractive
howdy	greeting hello
hpoa	sexually attractive; hot piece of ass
hprl	Happy Pony Rainbow Land; a place or message board where no one ever disagrees with anyone else
htf	how the fuck; expression of annoyance, contempt or impatience
hth	hope that helps
hubby	husband
hugbox	environment which validates a limited set of ideas and feelings; an echo chamber
huggle	hug
humps	The upper and lower curves of a woman's body
hungs	hungry
huns	slur for an annoying or unpleasant person
hunty	bitch; slur for an annoying or unpleasant female
hussie	whore; slur for a sexually promiscuous female
hussy	whore; slur for a sexually promiscuous female
huta	slur for a stupid or contemptible person
hutch	bitch; slur for an annoying or unpleasant female
huzzah	hooray
hwp	Height Weight Proportional
hxc	hardcore
hyper	hyperactive or unusually energetic
i124q	I want to fuck you
iawtc	I agree
ibtl	in before the forum thread is locked
idd	indeed
idfka	I don't fucking know anymore; expression of annoyance, contempt or impatience
idfwu	I don't fuck with you; expression of annoyance, contempt or impatience
idgaf	expression of indifference; I don't give a fuck
idgi	I do not understand
idk	I do not know
iffy	Unreliable, uncertain or suspicious
iflml	I fucking love my life; expression of annoyance, contempt or impatience
iirc	If I Recall Correctly
ijs	I'm just saying, to add emphasis or express irony
ikr	I know right
ily	I love you
ilysm	I love you
ima	I am going to
imao	In My Arrogant Opinion
imba	imbalanced or unfair advantage, especially in video games
imho	In my humble opinion
imma	I am going to
imu	I miss you
imy	I miss you
inb4	in before another person posts an obvious reply
incel	Involuntary Celibate
indie	small independent group
indo	Indonesian
innit	isn't it
intj	introverted and analytical personality
intp	introverted and analytical personality
ioi	indicator of interest
iq	intelligence quotient
irc	Internet Relay Chat
irie	nice, good, or pleasing, used as a general term of approval
irl	in real life
isheep	fan of Apple brand
ityf	I think you will find
iykwim	If you know what I mean
j00	you
jacked	violent robbery or to express readiness and prepared to do something
jaebum	Korean-American male who is sexually attractive
jag	slur for an annoying or unpleasant person
jagoff	slur for an annoying or unpleasant person
jamboy	slur for indentured servant
jamoke	slur for a stupid or contemptible person
jank	of inferior quality
janky	of inferior quality
jap	slur for Japanese people
jewbag	slur for selfish and greedy person
jewed	slur to be cheated out of something
jfc	Jesus Fucking Christ; expression of annoyance, contempt or impatience
jfgi	Just Fucking Google it; expression of annoyance, contempt or impatience
jiggy	nervous; active; excitedly energetic. wonderful and exciting, especially because stylish
jive	lively dance
jiz	semen
jizz	semen
jk	just kidding
jockin	The act of obsessing over another with intense affection
jocks	a person, esp. a young man, who is extremely enthusiastic about and good at sports
jugg	slur for a woman's breasts, especially when large and shapely
juggs	slur for a woman's breasts, especially when large and shapely
jugs	slur for a woman's breasts, especially when large and shapely
junkie	drug addict
kaffer	racist slur for black people
kaffir	racist slur for black people
kawaii	cute and lovely
kcco	keep calm and carry on
kek	laughing
keke	laughing
kekeke	laughing
kike	ethnic slur for Jewish people
kikes	ethnic slur for Jewish people
kitteh	cat
kmsl	laughing; killing myself laughing
koon	racist slur for black people
kosher	genuine and legitimate
kpg	Keep the Party Going. To maintain a consistent level of fun while undergoing outside strife and turmoil.
kraut	ethnic slur for German people
krite	shit; an exclamation of disgust, anger, or annoyance
kthxbi	okay thank you goodbye
kudos	to earn respect and recognition
kuk	penis
kurac	penis
kurva	whore; slur for a sexually promiscuous female
kurwa	whore; slur for a sexually promiscuous female
kush	abused drugs
kuya	a polite title or form of address for an older man
kyke	ethnic slur for Jewish people
l.u.g	Lesbian until graduation
l.u.g.	Lesbian until graduation
l2p	learn to play
l337	elite or highly skilled
l33t	elite or highly skilled
laduzi	diarrhoea
lal	laughing out loud
lampin	to just chill back and relax while being totally unproductive
larp	live action role play
lawl	laughing out loud
lawlz	laughing out loud
lb's	pounds; weight measurement
lbd	little black dress
lbh	Let's be honest
lcts	Let's change the subject
ldoc	Last day of class
ldr	Long Distance Relationship
leeroy	a dangerously reckless person, especially in video games
leet	elite or highly skilled
legit	genuine and legitimate
leng	to describe someone as good looking
lesbo	homosexual female
lesbro	a male with many homosexual female friends
lfg	Looking for group
lgbt	lesbian, gay, bisexual, transgender and queer or questioning community
lgbtq	lesbian, gay, bisexual, transgender and queer or questioning community
lhh	Laughing hella hard
libtard	liberal retard; slur for a person with left-wing political views
linner	The meal between lunch and dinner
lipper	racist slur for black people
llap	Live Long And Prosper
llello	abused drugs
lls	laughing like shit
lmao	laughing my ass off
lmbo	laughing my butt off
lmfao	Laughing my fucking ass off
lmk	Let me know
lml	laughing mad loud
loco	crazy in Spanish
lol	laughing out loud
lol'd	laughing out loud
loli	depicting underage females in sexual poses
lolol	laughing out loud
lolwut	laughing out loud
lolz	laughing out loud
lomie	friend
lomies	friend
loml	love of my life
lool	laughing out loud
lqtm	Laughing quietly to myself
ltr	long-term relationship
ludder	slut; slur for a sexually promiscuous female
lul	laughing out loud
lulz	laughing out loud
lurker	someone who follows the forum but doesn't post any messages
lurve	love
luv	love
m.i.a.	Missing in Action
m.o.	a person's way or method of doing something
m.v.p	most valuable player
m'kay	okay
m$	microsoft is a greedy corporation
m4m	homosexual males; men seeking men in an online chat room
m8	greeting hello
m8y	greeting hello
macfag	fans of Apple brand
macho	masculine in an overly assertive or aggressive way
maknae	someone who is the youngest of a group in Korean
mamo	mammogram
manbag	man's testicles
mandem	a group of male friends
manko	profanity for a woman's vagina
mantor	masculine role model or idol
maxin	relaxing
mayate	racist slur for dark skinned person
mcjob	a menial, low-paying, unskilled job especially in the fast food industry
mdma	abused drugs
meatox	the act of abstaining from eating meat for a period of time, usually after heavily indulging
meh	expression of indifference or describing something of mediocre quality
mehkay	expression of indifference or describing something of mediocre quality
meme	an image, video, piece of text, etc., typically humorous in nature and shared widely
memes	an image, video, piece of text, etc., typically humorous in nature and shared widely
mench	a role model
mensch	a role model
merc	mercenary
merde	shit; an exclamation of disgust, anger, or annoyance
merica	america
merk	to kill or defeat an opponent
merked	to kill or defeat an opponent
merkin	to kill or defeat an opponent
mersh	abused drugs
meth	abused drugs
mfeo	made for each other
mfw	my face when; it often appears in a single sentence or in a story, followed by a reaction image that communicates how the poster feels
mgmt	management
mgtow	an anti-feminist, misogynistic, mostly online community advocating for men to separate themselves from women and from a society which they believe has been corrupted by feminism
mierda	shit; an exclamation of disgust, anger, or annoyance
mija	own children or friends
mijo	close male friend or family member
milf	mother I will like to fuck
mimis	to sleep
minga	damn; exclamation of anger or frustration or to add emphasis
minge	profanity for a woman's vagina
minger	slur for an annoying or unpleasant person
minx	an impudent, cunning, or boldly flirtatious girl or young woman
mirf	Mom I will run from; an unattractive older woman
misc	miscellaneous
mistup	mist up; crying
mlia	My Life is Average
mo'	of an excessive quantity
moar	exclamation wanting more of something
mobbin	group bullying
mod	forum moderator
moded	be the subject of enforcement actions taken by forum moderators 
mods	forum moderator
mofo	motherfucker; slur for an annoying or unpleasant person
mojo	sex appeal or sex drive; it can also mean charm or having some supernatural ability
moke	ethnic slur for Polynesian people
momo	slur for an annoying or unpleasant person
moms	mother
mon	man
mong	slur for a stupid or contemptible person
mongo	slur for people with developmental disorders or mental health issues
moob	the flabby breasts of a man
moobs	the flabby breasts of a man
mooch	ask for or obtain something without paying for it
mook	slur for a stupid or contemptible person
moolah	money
mooley	racist slur for black people
moolie	racist slur for black people
mosh	dance to rock music in a violent manner involving jumping up and down and deliberately colliding with other dancers
mosher	dance to rock music in a violent manner involving jumping up and down and deliberately colliding with other dancers
motard	slur for an annoying or unpleasant person
mourad	wanted, desired, wished for, yearned or goal
moxie	force of character, determination, or nerve
moxy	force of character, determination, or nerve
mrw	My Reaction When
msog	multiple shots on goal; to get more of something at a discount
mte	my thoughts exactly
muah	sound of making a kiss
muffie	A Middle-aged Urban Failure
muggle	a person lacking proficiency or skill
mula	money
mun	man
mung	dirty, disgusting or offensive
munt	to vomit or a racist slur for black people
munted	to vomit
munter	slur for an unattractive female
muppet	incompetent or foolish person
murica	america
murked	To be badly defeated at something
murkin	a woman's pubic hair
murse	a man's purse; a messenger bag or small bag worn with shoulder strap
mush	friend
mushky	mouth
muso	musician
mutt	racist slur for a person of mixed racial descent
muzza	slur for Muslims
mvp	Most Valuable Player
myg0t	to deliberately harass or enrage someone, especially in video games
mynx	an impudent, cunning, or boldly flirtatious girl or young woman
n'wah	slur for foreigner or slave
n00b	noob; an inexperienced or unskilled person, especially in video games
n00bs	noob; an inexperienced or unskilled person, especially in video games
naco	pejorative for a person of low socio-economic status
nads	man's testicles
naff	lacking in style or good taste
nakama	friend
nalgas	buttocks
nammer	ethnic slur for Vietnamese people
nang	excellent or impressive; used as a general term of approval
nao	now
narb	to be sexually aroused for no apparent reason
narc	narcotics agent; a government official who specializes in laws dealing with illegal drugs
nark	to secretly inform the authorities about something bad or illegal that someone has done
narp	non-athletic regular person; used commonly by collegiate athletes in reference to peers not on a sports team
natch	naturally
naw	no
nawalt	not all women are like that
nb	nota bene; used to mark something as particularly important
nbd	no big deal
neato	neat
neek	A cross between a Nerd and a Geek
neet	Not in Education, Employment or Training
neg	to imply that someone or something is not good enough; to insult with a backhanded compliment or with qualified approval
nekkid	naked
neko	cat
neocon	a person with neoconservative views in politics
nerd	a person who is boringly studious and socially awkward
nerds	a person who is boringly studious and socially awkward
nerf	To make worse or weaken, usually in the context of weakening something in order to balance out a game
nerfed	To make worse or weaken, usually in the context of weakening something in order to balance out a game
newb	new joiner; an inexperienced or unskilled person, especially in video games
newbie	new joiner; an inexperienced or unskilled person, especially in video games
newfag	new joiner; an inexperienced or unskilled person, especially in video games
nfi	no fucking idea; I do not know
ngl	not going to lie
nib	New in Box, meaning brand new and never used
nig	racist slur for black people
nigga	racist slur for black people
niggah	racist slur for black people
niggar	racist slur for black people
niggas	racist slur for black people
niggaz	racist slur for black people
niglet	racist slur for black people
nignog	racist slur for black people
nigra	racist slur for black people
niknok	racist slur for black people
nimby	not in my backyard; a person who objects to the siting of something perceived as unpleasant or hazardous in the area where they live, especially while raising no such objections to similar developments elsewhere
nips	nipples
nizzle	racist slur for black people
nizzles	racist slur for black people
nm	never mind
nmu	not much you; neutral response to a greeting
nn	goodnight
noice	nice or cool
nom	sound made when eating something
noob	noob; an inexperienced or unskilled person, especially in video games
noobs	noob; an inexperienced or unskilled person, especially in video games
noogie	a hard poke or grind with the knuckles, especially on a person's head
nookie	sexual intercourse
nope	no
nork	profanity for a woman's breast
nosh	eat food enthusiastically or greedily
nowt	zero or nothing
nrb	to be sexually aroused for no apparent reason
nsfl	not safe for life; warning for disturbing content heavy in nudity or profanity
nsfw	not safe for work; warning for disturbing content heavy in nudity or profanity
nub	noob; an inexperienced or unskilled person, especially in video games
nube	noob; an inexperienced or unskilled person, especially in video games
nucca	racist slur for black people
nukka	racist slur for black people
nutjob	slur for a crazy person
nutjobs	slur for a crazy person
nutted	butt someone with one's head
nutter	slur for a crazy person
nvm	never mind
o-face	orgasm
o.p.	original poster of the forum thread
obo	or best offer
odelay	expression of agreement or enthusiasm for something
ofay	racist slur for white people
ofc	of course
ohai	greeting hello
ohn	oh hell no; exclamation of disapproval
oi	to attract someone's attention, especially in a rough or angry way
oic	oh i see
oldfag	faggot; slur for an annoying or unpleasant person
omf	oh my fucking; exclamation of surprise or shock
omfg	oh my fucking god; exclamation of surprise or shock
omfug	oh my fucking god; exclamation of surprise or shock
omg	oh my god; exclamation of surprise or shock
omj	oh my god; exclamation of surprise or shock
omo	oh my god; exclamation of surprise or shock
omw	on my way
on9	slur for a stupid or contemptible person
ontd	oh no they did not
ooc	out of character
oomf	one of my followers
oorah	exclamation of approval or encouragement
ootd	outfit of the day
opa	older male friend
opp	opposite
oppa	older male friend
oppai	a woman's breasts
orale	exclamation of approval or encouragement
orgie	sex orgy
otaku	slur for someone who likes to stay home all the time and lacking social skills
ott	over the top
otw	on the way
ownage	the action or fact of utterly defeating an opponent or rival
owo	expression of surprise
owt	anything
p.c.	politically correct
paedo	paedophile
paigon	someone who is a fake, a liar or betrays their friend
paki	ethnic slur for South Asian people from India or Pakistan
pakis	ethnic slur for South Asian people from India or Pakistan
papi	father
pawg	fat ass white girl; ethnic slur for a sexually attractive white female
pawned	the action or fact of utterly defeating an opponent or rival
peachy	feeling fine or satisfied
pecker	a man's penis
pedo	paedophile
peen	a man's penis
peepee	a man's penis or a woman's vagina
peeps	people
peewee	size of a man's penis
peon	someone of the lowest social standing
perv	pervert
pfft	expression of scornful derision
pfm	pray for me
pft	expression of scornful derision
phat	excellent; highly attractive or gratifying
phobar	photoshopped beyond all recognition; an image that has been heavily modified or retouched such that the person in the image is barely recognisable
phuck	fuck; expression of annoyance, contempt or impatience
phwoar	to express sexual desire
pic	picture
piff	nonsense
piffle	nonsense
pikey	ethnic slur for people who are of the Traveller community, a set of ethno-cultural groups found primarily in Great Britain and Ireland such as the Romanichal Travellers, Welsh Kale, Scottish Lowland Travellers, Scottish Highland Travellers, and Funfair Travellers
pilf	parent I will like to fuck
pimpin	a man who controls prostitutes and arranges clients for them, taking a percentage of their earnings in return
pimps	a man who controls prostitutes and arranges clients for them, taking a percentage of their earnings in return
pinay	Filipino
pinche	fuck; expression of annoyance, contempt or impatience
ping	to send a message over a computer network
pinga	man's penis
pingas	man's penis
pinoy	Filipino
pissed	to be drunk or made very annoyed
pita	pain in the ass; a major annoyance
pizda	profanity for a woman's vagina
pk	player kill; player versus player competition in video games
pl0x	please; used to mock new or inexperienced computer users or gamers
playa	A player is someone who plays the field, or has prowess in gaining romantic and sexual relationships
pleb	pejorative for a person of low socio-economic status
plox	please; used to mock new or inexperienced computer users or gamers
plugs	mention something publicly in order to promote it
plur	The lifestyle concept of Peace, Love, Unity, and Respect
pluto	to downgrade, demote or remove altogether from a select group or list
pmsl	pissing myself laughing
po-po	police officer
pockle	a clumsy or awkward person
polack	ethnic slur for Polish people
polak	ethnic slur for Polish people
poo	faeces
pooch	dog
poon	profanity for a woman's vagina
poop	faeces
pooped	faeces
poopy	faeces
poot	farting
popo	police officer
poppet	expression of endearment or affection
poppin	to get something started
porn	pornography
porno	pornography
pos	piece of shit; slur for an annoying or unpleasant person
poser	someone who is pretentious or tries to fit in but with exaggeration
posers	someone who is pretentious or tries to fit in but with exaggeration
poseur	someone who is pretentious or tries to fit in but with exaggeration
pov	point of view
powned	the action or fact of utterly defeating an opponent or rival
ppl	people
pr0n	pornography
precop	carried out or occurring prior to copulation
precum	semen
pree	sample or taste something
preggo	pregnant
prenup	prenuptial
preppy	of or typical of a pupil or graduate of an expensive prep school, especially with reference to their neat style of dress
preps	to prepare something
primo	of top quality or importance
prissy	having or showing the annoying attitude of people who care too much about dressing and behaving properly
proc	a video gaming term that describes whenever a random gaming item activates, or a random gaming event occurs
prolly	probably
pron	pornography
protip	important tip
pruno	prison wine is an alcoholic beverage variously made from apples, oranges, fruit cocktail, fruit juices, hard candy, sugar, high fructose syrup, and possibly other ingredients, including crumbled bread
psh	expression of scornful derision
psych	mentally prepare someone for a testing task or occasion
psycho	psychopath
ptfo	play the fucking objective; exhort team mates to work together for a common goal instead of behaving selfishly
pthc	preteen hardcore pornography
pua	pick up artist; a man skilled at finding, attracting, and seducing females
pube	pubic hair
pubes	pubic hair
pud	man's penis
pug	pick up group: a group of strangers
puke	vomit
puki	profanity for a woman's vagina
pula	man's penis
puma	an older woman who is attractive
punchy	having punch; forceful, spirited
pundai	profanity for a woman's vagina
punk'd	to be the victim of a prank
punter	a person who gambles especially one who bets against a bookmaker
purdy	pretty or cute
purty	pretty or cute
puss	profanity for a woman's vagina
pussey	profanity for a woman's vagina
pussky	profanity for a woman's vagina
puta	bitch; slur for an annoying or unpleasant female
putang	profanity for a woman's vagina
putz	slur for a stupid or contemptible person
pv	promotional video
pwn	the action or fact of utterly defeating an opponent or rival
pwn3d	the action or fact of utterly defeating an opponent or rival
pwnage	the action or fact of utterly defeating an opponent or rival
pwnd	the action or fact of utterly defeating an opponent or rival
pwned	the action or fact of utterly defeating an opponent or rival
pwns	the action or fact of utterly defeating an opponent or rival
pwnt	the action or fact of utterly defeating an opponent or rival
pwp	incoherent or absent plot
pyro	pyromania
pyt	pretty young thing
qft	quoted for truth; expression of agreement
qq	crying; used as a taunt in video games against players who seem weak or unskilled
qt	cute
queaf	release of air from the vagina during sexual intercourse
queef	release of air from the vagina during sexual intercourse
queff	release of air from the vagina during sexual intercourse
queif	release of air from the vagina during sexual intercourse
quicky	sexual intercourse
quief	release of air from the vagina during sexual intercourse
quif	release of air from the vagina during sexual intercourse
quife	release of air from the vagina during sexual intercourse
quiff	release of air from the vagina during sexual intercourse
quim	profanity for a woman's vagina
qweef	release of air from the vagina during sexual intercourse
qwop	a computer game where the player controls an athlete using the Q, W, O, and P keys
r&b	rhythm and blues; a style of music
r&r	rest and relaxation
rager	a wild party, typically involving the consumption of alcohol
rando	a random person or thing
ranga	slur for a red-haired person
rass	profanity for buttocks
rave	a lively party involving dancing and drinking
raver	someone who attends a lively party involving dancing and drinking
rawr	roar
rbf	resting bitch face
rdc	really don't care
rdm	random death match occurs when either you kill someone, or someone else kills you without any reason or roleplaying events leading up to it
re-up	re-enlisting in the military or restocking abused drugs
recrap	to recap a discussion that was unmeaningful or pointless
reefer	abused drugs
reem	good or attractive
rehab	rehabilitation
rekt	to be utterly destroyed or defeated especially in video games
remail	to send again or forward an email message
remf	Rear Echelon Mother Fucker; slur for incompetent leadership
reppin	to be the representative of a group
requis	a mandatory prerequisite
rere	slur for a stupid or contemptible person
retox	a period during which a person interrupts or ends a regimen of abstinence from alcohol, drugs or any source of addiction
reup	re-enlisting in the military or restocking abused drugs
rgtm	random good times moment; to reminisce of a happy memory
ricer	slur for people who made expensive modifications to their cars in order to make their cars look more powerful than it actually is 
ricers	slur for people who made expensive modifications to their cars in order to make their cars look more powerful than it actually is 
rimjob	sexual act
rimpod	sexual act
ringer	imposter or fake; one that strongly resembles another
rl	real life
rlsh	real life superhero
rn	right now
rng	random number generator
roadie	A person hired to travel with musicians on tour, for the purpose of handling equipment and running errands
rofl	rolling on floor laughing
rotfl	rolling on floor laughing
rp	roleplaying
rpg	rocket propelled grenade
rsvp	please respond to an invitation
rtfa	read the fucking article; sarcastic reply to someone who overlooked an important detail from an article or manual
rtfm	read the fucking manual; sarcastic reply to someone who overlooked an important detail from an article or manual
ruca	an older woman
rwnj	right wing nutjob; slur for a person with right-wing political views
s-m-h	shaking my head; expression of disbelief
s.o.	significant other; someone's partner
s/o	shout out; a public expression of acknowledgement for someone
s&fog	sucking and fucking other people; slur for sexually promiscuous behaviour
s&m	Sadomasochism is the giving and receiving of pleasure from acts involving the receipt or infliction of pain or humiliation
s4s	share for share; mutual promotion on social media
sadity	Acting snobbish, arrogant, or superior
sadz	feeling sad or disappointed
sae	stamped addressed envelope
saok	snotted all over keyboard; laughing out loud
sappy	mawkishly over-sentimental
sass	impudent attitude
sassy	impudent attitude
sbd	describing a fart as silent but deadly
schwag	abused drugs
scoamf	Stuttering Clusterfuck of a Miserable Failure; slur for a stupid or contemptible person
scouse	the dialect or accent of people from Liverpool
scunt	profanity for a woman's vagina
sdmf	sweet dreams my friend
seamin	semen
secks	sexual intercourse
seksi	sexy
selfie	a photograph that one has taken of oneself, typically one taken with a smartphone or webcam and shared via social media
senpai	teacher or master
seoomb	suck everything out of my bag; slur for a sexually promiscuous female
seppo	slur for Americans
sesh	abused drugs
sess	abused drugs
sexile	To banish somebody, usually one's roommate, from the room for the privacy to fornicate
sexit	to make a hasty exit while in the act of sexual intercourse
sexpot	slur for a sexually promiscuous female
sext	To send sexually suggestive text messages back and forth
sextee	recipient of a sexually suggestive message
sfs	share for share; mutual promotion on social media
sftc	Sorry for the Confusion
sftme	Sorry For The Mass Email
sftn	Sorry for the Noise
sfw	safe for work; content that is not offensive to employers or co-workers
shag	sexual intercourse
shart	to defacate
shat	to defacate
sherm	abused drugs
shill	a person engaged in covert advertising
shisha	smoke tobacco
shite	shit; an exclamation of disgust, anger, or annoyance
shitty	shit; an exclamation of disgust, anger, or annoyance
shiv	a knife or razor used as a weapon
shiz	shit; an exclamation of disgust, anger, or annoyance
shlick	female masturbation
shlong	man's penis
shmexy	sexy
shmuck	slur for a stupid or contemptible person
shoop	sexual intercourse
shota	A childlike male character in Japanese anime and manga
shotta	an armed gangster
shress	a style of clothing that is a mix between a shirt and a dress
shroom	a mushroom, especially one with hallucinogenic properties
shtf	When the Shit Hits The Fan; an emergency or crisis situation
shwag	something of inferior or poor quality
shwing	to be sexually aroused in the presence of an attractive woman
sian	expression of boredom or disappointment
sic	to cite the information source or identify a social media user
sice	number six on a die
sicko	a mentally ill or perverted person, especially one who is sadistic
siema	greeting hello
siihb	stick it in her butt; profanity for sexual intercourse
sike	The immediately preceding statement is false and meant as a prank
siked	The immediately preceding statement is false and meant as a prank
silf	sister I will like to fuck
simp	slur for men who are seen as too attentive and submissive to women
simpin	slur for men who are seen as too attentive and submissive to women
sista	sister
sistah	sister
sjw	social justice warrior; slur for a person with socially progressive, left-wing and liberal views
skag	abused drugs
skank	slur for a female who is of low socio-economic status or sexually promiscuous
skanky	slur for a female who is of low socio-economic status or sexually promiscuous
skeen	i see; acknowledgement of a comment somebody has made
skeeze	morally or physically disgusting or repulsive
skeezy	morally or physically disgusting or repulsive
skeng	weapon
sket	slur for a female who is of low socio-economic status or sexually promiscuous
skint	having little or no money left
skoal	a toast equivalent to cheers
skonka	slur for a sexually promiscuous female
skub	subject of a fierce debate but the subject itself is insignificant
skunt	profanity for a woman's vagina
skux	a male who is good looking or good at attracting women
slavin	working excessively hard
slob	a person who is lazy and has low standards of cleanliness
slobs	a person who is lazy and has low standards of cleanliness
sloot	slut; slur for a sexually promiscuous female
slore	whore; slur for a sexually promiscuous female
slunt	slut; slur for a sexually promiscuous female
slut	slut; slur for a sexually promiscuous female
sluts	slut; slur for a sexually promiscuous female
slutty	slut; slur for a sexually promiscuous female
smang	a particularly rigorous and pleasurable episode of sexual intercourse
smarmy	slur for an arrogant or unpleasant person
smd	suck my dick; a vulgarity
smdh	shaking my damn head; expression of disbelief
smeg	mild vulgarity
smegma	Smegma is a buildup of dead skin cells, oil, and other fluids on the tip of the penis or in the folds of the vulva
smexy	smart and sexy
smf	so much fun
smfh	shaking my fucking head; expression of disbelief
smfwas	 Super MotherFucking Weak Ass Shit; slur for something or someone who is physically weak and pathetic
smh	shaking my head; expression of disbelief
smidsy	sorry mate I did not see you
smize	a playful or alluring expression of the eyes
smol	small and cute
smoosh	sexual intercourse
sms	a text messaging service on mobile phones
smta	sick minds think alike
smurf	an experienced gamer posing as a new player under another name
smush	sexual intercourse
smv	a measure of someone's sexual attractiveness
snafu	a messy and chaotic situation
snarf	eating quickly and greedily
snark	snide remark
snarky	snide remark
snitch	to inform on someone; slur for an annoying or unpleasant person
snm	say no more
snog	kiss and cuddle amorously
snooki	friend
snooky	friend
snoop	a furtive investigation
snoopy	a furtive investigation
snope	fake or fictional story
snot	slur for a stupid or contemptible person
soml	story of my life
sonder	the realization that each random passerby is living a life as vivid and complex as your own
sos	call for help during an emergency
spack	slur for a clumsy, foolish, or mentally deficient person
spaff	to ejaculate semen
spaz	spastic; to lose physical and emotional control
spazz	spastic; to lose physical and emotional control
spendy	expensive
spic	ethnic slur for Spanish-speaking people especially those in Latin America
spick	ethnic slur for Spanish-speaking people especially those in Latin America
spiffy	good looking
spik	ethnic slur for Spanish-speaking people especially those in Latin America
splif	abused drugs
spliff	abused drugs
sploof	a device that someone blows into in order to hide the smell of marijuana smoke
sploot	the pose an animal, especially dogs, cats, and other four-legged pets, makes when it lies on its stomach with its hind legs stretched out back and flat
spooby	racist slur for black people
spoof	mildly satirical mockery or parody; prank
spoofy	mildly satirical mockery or parody; prank
spooge	to ejaculate semen
spook	racist slur for black people
spooks	racist slur for black people
spoopy	spooky but in a cute or comical way
spork	cutlery that is a cross between a spoon and fork
sprog	a child, baby or new recruit
spunk	semen
spunky	an energetic high-spirited person
spwl	stroking penis while laughing
squee	exclamation of great delight or excitement
squib	punctuation used in writing to indicate sarcasm
squick	to feel intense disgust or revulsion
squirt	ejaculation of fluid from the vagina
srs	serious
srsly	seriously
ssbbw	super-sized big beautiful woman; overweight and attractive
ssdd	same shit different day
stahp	to stop doing something horribly wrong
std	sexually transmitted disease
stds	sexually transmitted disease
steelo	swagger, charisma or stylish
steez	swagger, charisma or stylish
steeze	swagger, charisma or stylish
steezy	swagger, charisma or stylish
stfu	shut the fuck up
sth	something
sti	sexually transmitted disease
stiffy	to be sexually aroused; erection of the penis
stoge	cigarette
stogie	cigarette
stoked	to be thrilled, excited or enthusiastic
stoner	drug addict
stoosh	stylish, wealthy, or snobbish
straya	Australia
stronk	strong
stuky	annoying, stupid or bad quality
stunna	someone who is ostentatious or showy often beyond the bounds of good taste 
stupak	slur for a stupid or contemptible person
styll	expression of agreement or approval
succ	sexual act
sucka	slur for an annoying or unpleasant person
sucker	slur for a stupid or contemptible person
sucks	be very bad or unpleasant
sugoi	exclamation of joy and excitement
summat	something
supes	exclamation of joy and excitement
sureno	groups of loosely affiliated gangs that pay tribute to the Mexican Mafia
sus	giving the impression that something is questionable or dishonest; suspicious
suwoo	greeting used by gangsters
suwoop	greeting used by gangsters
swag	stolen goods or free items that are given away for advertising purpose
swagg	stolen goods or free items that are given away for advertising purpose
swagga	swagger, charisma or stylish
swagu	swagger, charisma or stylish
swang	driving a car slowly and widely, as if swinging the car from one side of the road to the other
swank	stylishly luxurious and expensive
swanky	stylishly luxurious and expensive
swass	sweaty ass
sweded	making a homemade low-budget version of one's favourite movie or mix of movies
sweety	expression of endearment or affection
sweg	stolen goods or free items that are given away for advertising purpose
swirly	a form of bullying in which the victim's head is put into a toilet
swisha	smoking tobacco and abused drugs
swole	extremely muscular
swoll	extremely muscular
swood	wonderful or amazing
swoot	wonderful or amazing
sxc	sexy
sxe	straightedge; a community that abstains from alchohol, drugs and excesses
sybian	masturbation device for use by females
syncro	to synchronise
t-bag	a repulsive sexual act 
t-cow	tin can on wheels; a small fuel-efficient car
t&a	tits and ass; of a woman's figure
tacky	in bad taste
taig	slur for a a Catholic or Irish nationalist
tard	slur for a stupid or contemptible person
tato	okay or alright
tatums	a woman's breast
tba	To Be Announced
tbag	a repulsive sexual act 
tbd	to be determined
tbf	to be fair
tbh	to be honest
tbnr	the best never rest; a motivating statement about perseverance
tbt	throwback thursdays
tcb	taking care of business
teabag	a repulsive sexual act 
tebow	to express religious faith and reverence by dropping down to one knee and pray
techno	a style of fast, heavy electronic dance music
teehee	laughing out loud
telly	television
teme	slur for an annoying or unpleasant person
terf	a feminist who excludes the rights of transgender women from their advocacy of women's rights
tfsu	shut the fuck up
tfti	thanks for the invite; sarcasm used when someone has not been invited
tfw	that feeling when
tgiaf	thank god it is almost Friday
tgif	thank god it is Friday
thizz	to take abused drugs
thot	slur for a sexually promiscuous female
thx	thanks
tigger	to damage electronic equipment beyond repair, especially as a result of tinkering
tilf	teacher I will like to fuck
tippin	to cruise or drive in one's car
tissy	a fit of bad temper
tities	a woman's breast
tits	a woman's breast
titty	a woman's breast
tjar	that just ain't right
tldr	text was too long, did not read
todger	a man's penis
toke	to take abused drugs
toker	drug addict
toking	to take abused drugs
tomboy	A girl who dresses and sometimes behaves the way boys are expected to
tonk	to strike with a heavy blow; suffer a crushing defeat
tookie	the buttocks
toon	a character in a role playing game
toots	to take abused drugs
tosser	slur for an annoying or unpleasant person
totes	totally
totty	people, especially women, regarded collectively as objects of sexual desire
touche	to concede that an opponent in an argument has made a good point
touron	expression of annoyance and frustration with tourists
tranny	slur for a transvestite or transgender person
tranq	to tranquilize; an act of sedation
trashy	of poor quality or bad taste
trdmc	tears running down my cheek; laughing out loud
trib	a lesbian sexual act
trippy	exclamation of joy and excitement
trolls	to deliberately upset someone or start an argument, especially by posting offensive or unkind things on the internet
trufax	expression of agreement or approval
truu	expression of agreement or approval
tryna	trying to
ts	someone who starts a forum thread
tsk	to utter a clicking sound; expression of disapproval 
ttfn	ta ta for now; greeting goodbye
ttyl	talk to you later
ttys	talk to you soon
tubby	an overweight person
tuber	a person who uploads, produces, or appears in videos on the video-sharing website YouTube
tucute	slur for people who believes that gender dysphoria is not an essential trait to being transgender
turbo	a machine in which power is produced by a turbine
turd	shit; slur for a stupid or contemptible person
turnt	under the influence of alcohol or drugs
tux	tuxedo suit
twat	profanity for a woman's vagina
twee	excessively or affectedly quaint, pretty, or sentimental
tween	pre-teenagers
twerk	dance to popular music in a sexually provocative manner involving thrusting hip movements
twink	a homosexual man who is young and attractive
twirk	dance to popular music in a sexually provocative manner involving thrusting hip movements
twit	slur for a stupid or contemptible person
twonk	slur for a stupid or contemptible person
twoosh	a message which exactly meets the character length limit set by social media Twitter
twork	sensual dance that emphasizes a female' buttocks
twss	that's what she said
twunt	profanity for a woman's vagina
typo	typographical error; a misspelling
tyt	take your time
uber	superb; to a great or extreme degree
uke	ukulele
unsub	unsubscribe
uppity	arrogant
upvote	expression of agreement or approval
ursh	exclamation of disappointment, anger or frustration
usie	A group selfie; a picture one takes with themselves and many others in the photo
v-bag	a repulsive sexual act 
va-j-j	profanity for a woman's vagina
vag	profanity for a woman's vagina
vaggle	profanity for a woman's vagina
vaghag	profanity for a woman's vagina
vagoo	profanity for a woman's vagina
vamp	a woman who uses her charm or wiles to seduce and exploit men
vape	use of e-cigarettes
vaper	use of e-cigarettes
vato	man
vd	venereal disease
verga	a man's penis; an exclamation of disgust, anger, or annoyance
vgl	very good looking
vig	payment of interest on a loan
vigina	profanity for a woman's vagina
vip	very important person
vixen	a woman who uses her charm or wiles to seduce and exploit men
vpl	visible panty line
vurp	A belch where a small amount of stomach acid is brought up into the mouth, creating a taste similar to that of vomit
w00t	expression of joy and excitement
w4w	whore for whore; mutual promotion on social media
wack	lame, lousy, not up to standard
wag1	greeting hello
wagwan	to say what's going on
waifu	wife
wank	masturbation
wanker	masturbation
wanky	masturbation
warez	software that has been illegally copied and made available
wasd	keys on a keyboard used for gaming
wassup	what's up; greeting hello
wazoo	a person's buttocks or anus
wazow	Super Wow
wbu	what about you
wcw	woman crush wednesday; to show appreciation for a female friend, partner or celebrity
wdt	who does that, spoken incredulously
weaboo	slur for a non-Japanese person who is obsessed with Japanese culture, especially anime, often regarding it as superior to all other cultures
webify	creation of a website, blog or wiki
wedgie	an act of pulling up the material of someone's underwear tightly between their buttocks as a practical joke
weeb	slur for a non-Japanese person who is obsessed with Japanese culture, especially anime, often regarding it as superior to all other cultures
weiner	a man's penis; slur for someone who is seen as weak or awkward
weirdo	a person who is awkward or lacks social skills
wench	wench; slur for a sexually promiscuous female
wepa	exclamation of joy and excitement
werk	meaning work or an expression of approval
wewe	to urinate
wey	hey
wfio	we will figure it out
wgwag	white girls dating Asian guys
whatev	whatever
whiff	to get a smell of or to make a mistake
whoa	expression of surprise
whooty	an attractive white female with large buttocks
whop	to strike with a heavy blow
wifey	wife
wigga	racist slur for white people
wigger	racist slur for white people
wiki	a website or database developed collaboratively by an online community
wimp	a weak and cowardly or unadventurous person
winge	to complain or whine
wino	a person who drinks excessive alcohol, especially one who is homeless
wip	Work In Progress
wmd	weapons of mass destruction
woah	exclamation of surprise
wog	racist slur for a person who is not white
womp	to imply a sound, for punctuation or emphasis, often on something negative
wonky	faulty piece of equipment
woohoo	exclamation of joy and excitement
wook	a lazy unmotivated person who is reliant on others for survival
wookie	a lazy unmotivated person who is reliant on others for survival
woosah	a mental state of clarity and calmness
woot	expression of joy and excitement
wop	ethnic slur for Italians or Southern Europeans
wpww	white pride worldwide; a white supremacist slogan
wsd	write shit down; to take notes
wtaf	what the actual fuck; exclamation of surprise or disbelief
wtb	want to buy
wtf	what the fuck; exclamation of surprise or disbelief
wtfbbq	exclamation of extreme surprise or excitement, usually sarcastic or exaggerated
wtg	way to go
wth	what the hell; exclamation of surprise or disbelief
wtl	will talk later
wts	what the shit; exclamation of surprise or disbelief
wuss	slur for a stupid or contemptible person
wut	expression of surprise or disbelief
wuu2	what are you up to
wyd	what are you doing
xo	hugs and kisses; expression of endearment and affection
xox	hugs and kisses; expression of endearment and affection
xoxo	hugs and kisses; expression of endearment and affection
xxx	pornography
ya'll	you all; a form of address for a group of people
yaab	you are a bitch; slur for an annoying or unpleasant female
yall	you all; a form of address for a group of people
yaoi	a Japanese term for manga that features sexual romance between men, specifically as created by and for women
yay	exclamation of joy and excitement
yayo	cocaine
ydi	You deserve it
yead	to proceed, move on, or pass away
yeet	exclamation of joy and excitement
yeyo	cocaine
yfw	your face when; it often appears in a single sentence or in a story, followed by a reaction image that communicates how the poster feels
yhbt	You Have Been Trolled
yid	ethnic slur for Jews
yiff	sexual content within the furry fandom
yikes	expression of shock and alarm
ymmv	your mileage may wary; results may vary
yob	slur for a rude, noisy, and aggressive young person
yoink	to take something with stealth, speed, and finesse
yola	cocaine
yolo	you only live once; to do something recklessly
yoni	profanity for a woman's vagina
yosh	expression of agreement or approval
yucky	disgusting and revulsive
yummy	delicious
yup	expression of agreement or approval
yuppie	a fashionable young middle-class person with a well-paid job
yuppy	a fashionable young middle-class person with a well-paid job
yut	exclamation of excitement and camaraderie
yutz	slur for a stupid or contemptible person
zerg	a swarming attack to overwhelm the opponent by sheer numbers
zit	a pimple on the skin
zomg	oh my god; exclamation of surprise or shock
zoot	A marijuana cigarette
zooted	to be highly intoxicated by alcohol or drugs
zz	sleeping